11111111
101CCC11
10111011
10111011
1000CC01
1E000101
10000011
1P000001
11111111
