1111111111111111
1CCCC000CCC11111
1CCCC000CCC11111
1CCCC000CCC11111
1CCCC000CCC11111
10000CCC00011111
100000CC00011111
10000CCC00011111
1CCCCCCCCCC11111
1000000000011111
1000000000011111
1000000000P11111
1000000000011111
1000000000011111
1000000000E11111
1111111111111111
1111111111111111
