11111111111111111111111111111111111111111111111111111111
10000000000000000000000000000000000000000000000000000001
10111111111111111111111111111111111111111111111111111101
101E00V0010001C0000000000000000000000000000000000000C101
10111011111111110111111111110C1111110111111111111C111101
1011C00010001000000000001110011111000000000000011C000101
10111010101010111111111011101111111111111111011111110101
101C10101010101111111110111011111111111111110111C0110101
10101010001000111111000000000000000000000000000000010101
10101011111111110001111111111100001111111111111111010101
101000111110000101011111111110011111100C111C001111010101
1011111111101101010000000000C101C00110111110101C00010101
10111111111C11000111111111111111010110000110101111110101
101011111111110111100000000100C1010111110000100000000101
10111111111111011110111111010101010111110011100011111101
10101010101010011110111111010101010111110011100111111101
10110101010101011110111111000101010111110011100111111101
10100000000000000000111110000000000000000000000000001101
101C11111111111111111111111111111111111111111111111P1101
10111111111111111111111111111111111111111111111111111101
10000000000000000000000000000000000000000000000000000001
11111111111111111111111111111111111111111111111111111111
