11111
1CE01
1P001
11CC1
11111
