111111111111111
1CCCC000CCC1111
1CCCC000CCC1111
1CCCC000CCC1111
1CCCC000CCC1111
10000CCC0001111
100000CC0001111
10000CCC0001111
1CCCCCCCCCC1111
100000000001111
1000V0000001111
1000000000P1111
100000000001111
100000000001111
1000000000E1111
111111111111111
111111111111111
