111111
1CE111
1P0111
111111
111111
