11111111111111
1CCCC0000CCC11
1CCCC0000CCC11
1CCCC0000CCC11
1CCCC0000CCC11
10000CCCC00011
10000C0CC00011
10000CCCC00011
1CCCCCCCCCCC11
10000000000011
10000000000011
10000000000P11
10000000000011
10000000000011
10000000000E11
11111111111111
11111111111111
