11111111111111111111
1CCCC0000CCCC0000001
1CCCC0000CCCC0000001
1CCCC0000CCCC0000001
1CCCC0000CCCC0000001
10000CCCC0000CCCC001
10VV0C0CC0000CCCC001
10000CCCC0000CCCC001
10000CCCC0000CCCC001
10000000000000000001
10000000000000000001
10000000000P00000001
10000000000000000001
10000000000000000001
100000000000000000E1
11111111111111111111
