111111111111111111111111111111111111
100000000000C00000000000000000000001
111111111100100000000000000000000001
100000000000100000000000000000000001
111111111111100000000000000000000001
111EP1111111100000000000000000000001
100000000000C00000000000000000000001
111111111100100000000000000000000001
100000000000100000000000000000000001
111111111111100000000000000000000001
111111111111100000000000000000000001
100000000000C00000000000000000000001
111111111100100000000000000000000001
100000000000100000000000000000000001
111111111111111111111111111111111111
