11111
1CEC1
1P0C1
11CC1
11111
