111111111111
1CCCC000CCC1
1CCCC000CCC1
1CCCC000CCC1
1CCCC000CCC1
10000CCC0001
100000CC0001
10000CCC0001
1CCCCCCCCCC1
100000000001
100000000001
1000000000P1
100000000001
100000000001
1000000000E1
111111111111
