11111
1CE01
1P001
1CCC1
11111
