11111111
1P00CCC1
1000CCC1
1000CCC1
1000CCC1
1CCC0001
1CCC0001
1CCC0001
10000001
100000E1
11111111
