NO ./texture/0.xpm
SO ./texture/1.xpm
WE ./texture/2.xpm
EA ./texture/3.xpm

F 100,100,5
C 8,8,8

        11111111111111111111111111
        100000000011010000000011111111111
        10110000011111000000011111111111111
        100100000000000000000111
11111111101100000111000000000001
100000000011000001110111111111111
11110111111111011100000010001         111
1111111111111011101010010001         101
11000000110101011100000010001         111
100N000000000000110000010001
10000000000000001101010010001
110000010101010111110111100111
11110111 1110101 101111010001
  111111 1111111 111111111111
