NO ./path_to_the_north_texture.xpm
SO ./path_to_the_south_texture.xpm
WE ./path_to_the_west_texture.xpm
EA ./path_to_the_east_texture.xpm

F 220,10,5
C 225,30,5

        11111111111111111111111111
        100000000011000000000011111111111
        10110000011100000000011111111111111
        1001000000000000000000111
111111111011000001110000000000001
100000000011000001110111111111111
11110111111111011100000010001         111
1111N111111111011101010010001         101
11000000110101011100000010001         111
1000000000000000110000010001
10000000000000001101010010001
110000010101010111110111100111
11110111 1110101 101111010001
  111111 1111111 111111111111
