
NO ./texture/jjangoo.xpm
EA ./texture/choco.xpm
SO ./texture/cloth.xpm

C 0,182,255 



F 100,100,5
WE ./texture/suji.xpm





        11111111111111111111111111
        100000000011010000000011111111111
        10110000011111000000011111111111111
        100100000000000000000111
11111111101100E00111000000000001
100000000011000001110111111111111
11111111111111111111111111111111


11111111111111111111111111111
11110111111111011100000010001         111
1111111111111011101010010001         101
11000010000101011100000010001         111
1000000000000000110000010001
10000000000000011010100100011
110000000000000111110111100111
11111111 1110101 101111010001
  111111 1111111 111111111111


  111
  101
  1111
