NO ./texture/0.xpm

SO ./texture/1.xpm

WE ./texture/2.xpm

EA ./texture/3.xpm

F 100,100,5

C 8,8,8

11111111111111
1100000000111
1000000000001
100000N000001
1000000000001
1111100001111
11111111111111
