11111
1CE01
1P001
10001
11111
