11111111111111111111111111111
1PEC0000000000000000000011111
10000000000000000000000011111
10000000000000000000000011111
10000000000000000000000011111
10000000000000000000000011111
10000000000000000000000011111
10000000000000000000000011111
10000000000000000000000011111
10000000000000000000000011111
10000000000000000000000011111
10000000000000000000000011111
10000000000000000000000011111
10000000000000000000000011111
11111111111111111111111111111
