11111111111111
1CCCC000CCC111
1CCCC000CCC111
1CCCC000CCC111
1CCCC000CCC111
10000CCC000111
100000CC000111
10000CCC000111
1CCCCCCCCCC111
10000000000111
1000V000000111
1000000000P111
10000000000111
10000000000111
1000000000E111
11111111111111
11111111111111
