111111111111111111111111111111111111
100000000000000000000000000000000001
101111111111111111111111111111111101
101E00V0010001C00000000000000000C101
10111011111111110111111111110C111101
1011C0001000100000000000111001100101
101110101010101111111110111011110101
101C10101010101111111110111011110101
101010100010001111110000000000000101
101010111111111100011111111111110101
101000111110000101011111111110010101
1011111111101101010000000000C1011101
10111111111C110001111111111111111101
101111111111110111100000000100C00101
101111111111110111101111110101001101
101010101010100111101111110101001101
101101010101010111101111110001001101
101000000000000000001111100000000101
101C111111111111111111111111111P1101
101111111111111111111111111111111101
100000000000000000000000000000000001
111111111111111111111111111111111111
