11111111
1000CCC1
1000CCC1
1000CCC1
1000CCC1
1CCC0001
10CC0001
1PCC0001
10000001
100000E1
11111111
