11111111111111
10011110000C1
10C11111110011
1PE01111000011
11111111111111
