11111111111111
100000000000C1
10C11111110011
1PE00000000011
11111111111111
